 ^^^^^^^^^^^^^^^^^^^^^^^^^^^^^^^^^^^^^^^^^^^^^^^^^^^^^^^^^^^^^^^^^^^^^^^^^
|    _____________   __________________________      ________   _______   
|   |             | |                          |    |Elefante|_|       |  
|   |  Auditórios | |   Titanic  🚢  | Bandeco |    | Branco  _  @   @ |   
|   |_____   _____| |       _ ◠ _    |   🍖    |    |___🐘___| |___ ___|    
|   ______| |_______|__  __| | | |__ |_________|     _______   |_____|    
|  |                         | |                    |       |   __ __   ◯ 
|  |            \__ __ __ __ | | __ __ __ __        |   🌳  |   ___    ___ 
|  |   queijo               || ||            \      | Grama |  |   |  |   
|  |     🧀   ◯  ________________________           |       |  |   |  |    
|  |          ◯ |                        |          |_______|  |___|  |___
|  |__  __  ____|      ^^^            ^^ |                                
| ____||__||               ^^^^          |________         _____    ____  
||        ||       ^^                             |_____  |     |__|    |_
|| Biblio ||_______   _________    ^^^        ^   |  🥐 | |             |_ 
|| -teca  ||       | | Ginásio |          ^^      |____ | |    CB 💻    || 
||   📖   ||       | |___🏐____|                  |______________  ______|  
||________||       |_____________________________________________________ 
|    P3____|                                                              
|                                                                         
 ^^^^^^^^^^^^^^^^^^^^^^^^^^^^^^^^^^^^^^^^^^^^^^^^^^^^^^^^^^^^^^^^^^^^^^^^^
